level=
############################
#............##............#
#.####.#####.##.#####.####.#
#@####.#####.##.#####.####@#
#.####.#####.##.#####.####.#
#..........................#
#.####.##.########.##.####.#
#.####.##.########.##.####.#
#......##....##....##......#
######.#####,##,#####.######
######.#####,##,#####.######
######.##,,,,,,,,,,##.######
######.##,###22###,##.######
######.##,########,##.######
,,,,,,.,,,##,,,,##,,,.,,,,,,
######.##,########,##.######
######.##,########,##.######
######.##,,,,,,,,,,##.######
######.##,########,##.######
######.##,########,##.######
#............##............#
#.####.#####.##.#####.####.#
#.####.#####.##.#####.####.#
#@..##.......,,.......##..@#
###.##.##.########.##.##.###
###.##.##.########.##.##.###
#......##....##....##......#
#.##########.##.##########.#
#.##########.##.##########.#
#..........................#
############################